1111111111111111111111111111111111
1E00000000000000000000000000000001
1010010100100000101001000000010101
1C10010010101010001001000000010101
1P00000000000000000000000000000001
1111111111111111111111111111111111
