111111111111111111111111111111111111
10P01110000000000000000000000000E001
1000000000000000111111100C000C000001
10000011111100000001100001100C000001
10000000000011111000C00111000C000001
100000000111110000001111110000001101
1000000C000C000000110000011111111101
10000000000000011111111100000C000101
10000000C000000000000000000000000101
111111111111111111111111111111111111
