1111111111111111111111111111111111111111111111
1P000000000C00001111111111100000000000000000E1
1011111110001111111111111111110111111111111101
1000000000100000000000000000000000000C00000001
1011101111111110111111111111111111011111111101
1000100000000010000000000000000001000000000101
1111111111101111111111111110111111111110111101
1000000000000000000000000000100000000000000001
101111111100000C000001111111111111111111111101
1000000000000010000000000000000000000000000001
1011111111111100000000011111111111111111111101
1000000000100000000000000000000000000000000001
1011101111111111111111111110111111110111111101
1000100000000000000000000000100000000000000101
1111111111111111111111111111111111111111111111