11111111111111111
1C00C001C100000C1
1C000P000E00000C1
1C00C00001C1000C1
11111111111111111
