111111111111111
1C00C0E11011011
100001111101101
1000C0001101101
1C00100C1101101
1000C000110C1C1
100C1C001101101
1000C0001C01101
100000001101101
1C00C00C11C1101
111111111111111