1111111111111111111111111111111
101000110000000P00000000000E001
100000110000000C000000000000001
1111110000000000000000000000001
1010000000000000000000000000001
1111111111111111011111111111111
