1111111111111111111111111111111
101000110000000000000000E000001
100P000000000000000000000000001
111111000000000000000000C000001
1010000000000000000000000000001
11111111111111111111111111111111
